6 6
######
##..S#
##.###
##.###
#F.###
######
