20 20
....................
....................
....................
....................
..##################
....#...............
..#.#.#.............
..#.#.#.............
..#.#.#.............
..#.#.#.............
..#.#.#.............
..#.#.#.............
..#.#.#.............
..#.#.#.............
..#.#.#.............
..#.#.#.............
..#.#.#.............
..#.#.#.............
.F#...#.........S...
####################
